"Score"
100
"Map"
1 1 1 1 1 1 1 1 1 1 1 1 1 1 1 1 1 1 1 1 1 1 1
1 2 2 2 0 2 0 0 0 2 0 0 0 2 2 2 0 0 2 2 0 2 1
1 5 1 0 1 2 1 2 1 0 1 2 1 0 1 2 1 2 1 0 1 0 1
1 2 2 2 0 0 0 2 2 2 0 0 0 2 2 0 2 2 0 5 2 0 1
1 0 1 0 1 0 1 2 1 0 1 0 1 2 1 2 1 0 1 2 1 2 1
1 0 2 2 2 2 2 0 0 0 2 2 0 0 0 0 2 0 0 2 0 0 1
1 5 1 2 1 0 1 0 1 0 1 2 1 0 1 0 1 2 1 0 1 0 1
1 2 0 2 2 0 0 2 2 2 0 0 0 0 0 2 2 2 2 2 2 2 1
1 0 1 0 1 2 1 0 1 2 1 0 1 0 1 0 1 2 1 2 1 2 1
1 0 2 2 0 2 2 0 2 3 0 0 0 0 5 0 6 0 0 0 2 0 1
1 2 1 2 1 0 1 0 1 0 1 0 1 0 1 0 1 2 1 0 1 0 1
1 0 0 2 0 0 0 0 2 2 0 0 0 2 2 0 2 0 2 0 2 0 1
1 2 1 0 1 2 1 2 1 0 1 0 1 2 1 2 1 0 1 2 1 0 1
1 2 2 2 0 2 0 0 0 2 0 0 2 2 0 2 0 0 2 2 0 0 1
1 1 1 1 1 1 1 1 1 1 1 1 1 1 1 1 1 1 1 1 1 1 1